Application = CS.UnityEngine.Application
GameObject = CS.UnityEngine.GameObject
DownLoadManager = CS.DownLoadManager.I
VersionManager = CS.VersionManager.I
SoundManager = CS.SoundManager.I
GamePlayerPrefs = CS.GamePlayerPrefs
Debug = CS.Debug
GameSettingUtil = CS.GameSettingUtil
UGUIScrollRect = CS.UGUIScrollRect
CommandOnGUI = CS.CommandOnGUI
DateTime = CS.System.DateTime
SerializeLangScript = CS.SerializeLangScript
ResourcesManager = CS.ResourcesManager.I
SimplePoolManager = CS.SimplePoolManager.I
EventTriggerDragListener = CS.EventTriggerDragListener
EventTriggerListener = CS.EventTriggerListener
DelayTimeexeManager = CS.DelayTimeexeManager.I
DelayFunStruct = CS.DelayFunStruct
SDKManager = CS.SDKManager.I
Time = CS.UnityEngine.Time
SystemInfo = CS.UnityEngine.SystemInfo
Animation = CS.UnityEngine.Animation
TalkAnimation = CS.TalkAnimation
AnimationClip = CS.UnityEngine.AnimationClip
Vector3 = CS.UnityEngine.Vector3
Vector2 = CS.UnityEngine.Vector2
Color = CS.UnityEngine.Color
Quaternion = CS.UnityEngine.Quaternion
CalendarPicker = CS.CalendarPicker
Camera = CS.UnityEngine.Camera
Input = CS.UnityEngine.Input
InputField = CS.UnityEngine.UI.InputField
Space = CS.UnityEngine.Space
Resources = CS.UnityEngine.Resources
AssetType = CS.AssetType
SerilizeInfo = CS.SerilizeInfo
Image = CS.UnityEngine.UI.Image
RawImage = CS.UnityEngine.UI.RawImage
Text = CS.UnityEngine.UI.Text
ScrollRect = CS.UnityEngine.UI.ScrollRect
Slider = CS.UnityEngine.UI.Slider
Dropdown = CS.UnityEngine.UI.Dropdown
UGUIDropdown = CS.UGUIDropdown
UGUISlider = CS.UGUISlider
CanvasGroup = CS.UnityEngine.CanvasGroup
GridLayoutGroup = CS.UnityEngine.UI.GridLayoutGroup
SpinWithMouse = CS.SpinWithMouse
UIAnimationType = CS.UIAnimationState
AnimationUtil = CS.AnimationUtil
CSUtil = CS.Util
LoadingAnimation = CS.LoadingAnimation
FunManager = CS.FunManager
DrawLineLR = CS.DrawLineLR
LineStruct = CS.LineStruct
BluetoothLEHardwareInterface = CS.BluetoothLEHardwareInterface
BluetoothDeviceScript = CS.BluetoothDeviceScript
CameraWaterWaveEffect = CS.CameraWaterWaveEffect
CameraOrRootSizeScale = CS.CameraOrRootSizeScale
PinYinConverterUtil = CS.PinYinConverterUtil
RectTransform = CS.UnityEngine.RectTransform
XLuaMonoBehaviour = CS.XLuaMonoBehaviour
SButton = CS.SButton
SButtonUGUI = CS.SButtonUGUI
CmdItem = CS.CmdItem
CmdItemUGUI = CS.CmdItemUGUI
SimpleJoysticks = CS.SimpleJoysticks
